[
	{
		"title": "Basic",
		"map": [
			"####################",
			"#..................#",
			"#..................#",
			"#.@..............O.#",
			"#..................#",
			"#..................#",
			"####################"
		]
	}, {
		"title": "The Wall",
		"map": [
			"####################",
			"#...........#......#",
			"#...........#......#",
			"#.@....#....#....O.#",
			"#......#...........#",
			"#......#...........#",
			"####################"
		]
	}, {
		"title": "Doppelganger",
		"map": [
			"####################",
			"#..........##......#",
			"#..........##......#",
			"#.@@...##..##..#OO##",
			"#......##..........#",
			"#......##..........#",
			"####################"
		]
	}, {
		"title": "Enjoy the Company",
		"map": [
			"########################",
			"#......................#",
			"#......................#",
			"#.#@......#O.#.........#",
			"#.O@@......#...........#",
			"#.#@...................#",
			"#................#O#...#",
			"#O#....................#",
			"########################"
		]
	}, {
		"title": "Pushy",
		"map": [
			"#######################",
			"#.#.........#.........#",
			"#.....#...#...#.......#",
			"#...#..#O.#.#....#...##",
			"#@.0.@....#...#....#..#",
			"#....#.##O...0.#......#",
			"#.....#......#........#",
			"#.#..........#........#",
			"#######################"
		]
	}, {
		"title": "Detour Ahead",
		"map": [
			"#######################",
			"#..........@@@........#",
			"#...##############....#",
			"#....0000........##...#",
			"##..######...#####....#",
			"#............#.....#..#",
			"#...##########..#..#..#",
			"#..........XXO..#.....#",
			"#######################"
		]
	}, {
		"title": "Worst Enemy (R to restart)",
		"map": [
			"#######################",
			"##00000#.###...#......#",
			"#.##000#....0X0.#...O.#",
			"#0.#0###..#....0.#....#",
			"#@0#0#.##0#....0...#..#",
			"#0.###....#....#.####X#",
			"#O.0.#0#0##.....#...0.#",
			"###....#.#......0..#..#",
			"#######################"
		]
	}, {
		"title": "Snarky Comment",
		"map": [
			"########################",
			"#.......#............###",
			"#.....#...#.....#......#",
			"#...O...........@...#..#",
			"#..#@0X.....O...#......#",
			"#..........O.O.........#",
			"#.#.....#.......#...#..#",
			"#.......@..#...........#",
			"########################"
		]
	}, {
		"title": "Asynchronous",
		"map": [
			"##########",
			"#.@.OO.@.#",
			"#........#",
			"#........#",
			"#...@@...#",
			"#........#",
			"#........#",
			"#.O0^^0O.#",
			"##########"
		]
	}, {
		"title": "Clever, Clever",
		"map": [
			"~~~~~~~~~~~~~~~~~~~~~~~~",
			"~~~~~~~~~~~~~~~~~~~~~~~~",
			"~~~~~~~~~~~~~~~~~~~~~~~~",
			"########################",
			"#O########..0..#########",
			"#@@..........^........O#",
			"########################",
			"~~~~~~~~~~~~~~~~~~~~~~~~",
			"~~~~~~~~~~~~~~~~~~~~~~~~",
			"~~~~~~~~~~~~~~~~~~~~~~~~"
		]
	}, {
		"title": "Don't Look Back",
		"map": [
			"########################",
			"#@........##.........O.#",
			"#.........|............#",
			"########################",
			"#@.@........|.........O#",
			"#...^.......|.........O#",
			"#O.O........#..........#",
			"########################"
		]
	}, {
		"title": "Chutes and Ladders",
		"map": [
			"########################",
			"#@>>>>.>>>v#v<>.>>>v<<<#",
			"#v....v.>>>>>^^v...v..^#",
			"#v....v^...#..^v...v..^#",
			"#v....v^<<<<<^v.>>>.>>.#",
			"#v....>>>>>>.^<v...^..v#",
			"#v.........#v^.>v<>^..v#",
			"#>>>>>>>>>>>>^<O.^.<<<<#",
			"########################"
		]
	}, {
		"title": "A Razor's Edge",
		"map": [
			"####                ####",
			"#...#              #...#",
			"#.@..~~~~~~~~~~~~~~..O.#",
			"#...#              #...#",
			"####                ####"
		]
	}, {
		"title": "Remote Control",
		"map": [
			"########################",
			"#@..#@..#..............#",
			"#.~.##..#..............#",
			"#...##..#..........#...#",
			"##..##..#>.#........^..#",
			"#X00~.#.#>.#....#...#..#",
			"###O..#>~.##>^##.###...#",
			"#O...<~~~~~~~~~~~~~~~..#",
			"########################"
		]
	}, {
		"title": "The Maze",
		"map": [
			"#######################",
			"#@.........#@#........#",
			"#...#......#.#.######.#",
			"#...#....#.#.#........#",
			"#...#....#.#..........#",
			"####.....#.##.........#",
			"#O.......#.#O########.#",
			"#..........#..........#",
			"#######################"
		]
	}, {
		"title": "Hole in the Wall",
		"map": [
			"########################",
			"#V~~~~~0.<#.........#O.#",
			"#V~~~~~.#^#.........#..#",
			"#V~~~~~..^#.........#..#",
			"..~~~~~.#.<@@.......#...",
			"#^~~~~~..V#.........#..#",
			"#^~~~~~.#V#.........#..#",
			"#^~~~~~0..#.........#O.#",
			"########################"
		]
	}, {
		"title": "Shipping Lane",
		"map": [
			"########################",
			"#..................>~~~#",
			"#@..................#.##",
			"#...................#O##",
			"###################^#O##",
			"#######...##...####0<###",
			"#.@.....0....0....0.####",
			"#################...####",
			"########################"
		]
	}, {
		"title": "Lend me a Hand",
		"map": [
			"########################",
			"#@...0..################",
			"#####.#0..##############",
			"#####...#.0........~~~~#",
			"#########.0........#.###",
			"#V#O#####.<<<<<<<<<#.###",
			"#@<O################.###",
			"#^<<<0<<<<<<<<<<<<<<<###",
			"########################"
		]
	}
]